8 8 4 14 14 14 14 14 14 14 14 14 14 6 8 8 4 14 14 14 14 14 5 5 6 
8 4 15 0 0 0 23 23 0 0 0 20 0 13 14 14 15 0 0 0 0 0 0 0 7 
4 15 0 0 25 0 1 3 22 0 0 0 0 0 0 0 0 0 0 20 0 0 25 0 7 
9 0 0 0 1 2 18 16 2 3 0 26 0 0 19 0 0 0 0 0 0 1 3 0 7 
9 0 0 1 18 8 4 14 14 15 0 1 3 0 1 3 0 0 21 0 22 7 16 2 18 
9 0 0 13 14 14 15 0 0 0 0 13 15 0 7 16 2 2 2 2 2 18 8 8 8 
9 24 0 0 0 0 0 0 0 0 0 0 0 0 7 8 8 8 8 8 8 8 8 8 8 
16 2 2 3 0 0 20 0 21 0 1 3 0 0 13 14 14 14 14 14 14 6 8 8 8 
4 14 14 16 2 2 2 2 2 2 18 15 0 0 0 0 0 0 0 0 0 13 14 14 6 
9 20 0 13 14 14 14 14 14 14 15 0 0 0 0 0 0 0 0 0 0 0 0 0 7 
9 0 0 0 0 0 0 0 0 0 0 0 0 0 0 0 20 20 0 0 0 0 0 0 7 
9 0 0 26 0 0 0 0 0 0 0 0 0 0 0 0 26 0 0 0 0 0 0 0 7 
16 2 2 2 3 0 0 0 0 0 0 0 0 0 0 0 1 2 3 0 0 0 0 0 7 
8 8 8 8 9 0 0 0 21 0 0 0 0 21 0 0 7 8 9 0 0 0 21 0 7 
8 8 8 8 16 2 2 2 2 2 2 2 2 2 2 2 8 8 16 2 2 2 2 2 18 
