4 14 14 14 14 14 14 14 14 14 14 14 14 6 4 14 14 14 14 14 14 14 5 5 6 
9 0 0 0 0 0 0 0 0 0 0 0 0 7 9 0 0 0 0 0 0 0 0 0 7 
9 19 24 0 25 22 20 20 20 20 0 0 0 7 9 0 0 0 0 0 0 0 0 0 7 
16 2 2 2 2 3 0 0 0 0 0 0 0 7 9 0 0 0 0 0 0 0 0 0 7 
4 14 14 6 4 15 0 0 0 0 0 0 22 7 9 0 0 0 0 0 0 0 0 0 7 
9 0 0 13 15 20 0 0 23 0 1 2 2 18 16 2 3 0 23 0 20 0 0 0 7 
9 0 0 0 0 0 0 0 1 2 18 8 8 8 8 8 16 2 3 0 0 0 0 0 7 
9 0 0 0 20 0 0 0 13 6 8 8 8 8 8 8 4 14 15 0 0 0 0 1 18 
9 0 20 1 3 0 0 0 0 13 14 14 14 14 14 14 15 0 0 0 0 0 1 18 8 
9 0 0 13 15 0 0 0 0 0 0 0 0 0 0 0 0 0 23 0 0 1 18 8 8 
9 20 0 0 0 0 0 0 0 0 25 0 0 0 0 20 0 1 3 0 0 13 14 14 6 
9 0 0 0 0 0 0 0 0 1 3 0 0 0 0 1 2 18 15 0 0 0 0 0 7 
9 0 0 0 0 0 0 0 1 18 16 3 0 0 0 13 14 15 0 0 0 0 0 0 7 
16 3 21 0 0 0 0 21 7 8 8 16 3 21 0 0 0 0 0 0 0 0 21 20 7 
8 16 2 2 2 2 2 2 18 8 8 8 16 2 2 2 2 2 2 2 2 2 2 2 18 
