8 8 4 14 14 14 14 14 14 14 14 14 14 6 8 8 4 14 14 14 14 14 14 6 8 
8 4 15 0 0 0 0 0 0 0 0 0 0 13 14 14 15 0 0 0 0 0 0 13 6 
4 15 0 0 0 0 0 0 0 0 0 0 0 0 0 0 0 0 0 0 0 0 0 0 7 
9 0 0 0 20 20 20 0 0 0 0 0 0 0 0 0 0 0 0 0 0 1 3 19 7 
9 0 0 20 0 0 0 20 0 0 0 0 0 0 1 3 0 21 0 0 0 7 16 2 18 
9 0 20 0 0 0 0 0 1 2 3 0 0 0 7 16 2 2 2 2 2 18 8 8 8 
9 20 20 0 0 0 0 0 13 14 15 0 0 0 7 8 8 8 8 8 8 8 8 8 8 
9 20 20 0 0 0 0 0 0 0 0 0 0 0 13 14 14 14 14 14 14 6 8 8 8 
9 0 0 0 0 0 0 0 0 0 0 0 0 0 0 0 0 0 0 0 0 13 14 14 6 
9 0 0 0 0 0 0 0 0 0 0 0 0 0 0 0 0 0 0 0 0 0 0 0 7 
9 0 0 0 0 0 0 0 0 0 20 20 20 20 20 20 20 20 0 0 0 0 0 0 7 
16 3 0 0 0 0 0 0 0 0 1 2 2 2 2 2 2 3 0 0 0 0 0 0 7 
8 16 2 2 3 0 0 0 0 1 18 8 8 8 8 8 8 16 3 0 0 0 0 0 7 
8 8 8 8 9 0 0 0 1 18 8 8 8 8 8 8 8 8 9 20 20 20 20 0 7 
8 8 8 8 16 2 2 2 18 8 8 8 8 8 8 8 8 8 16 2 2 2 2 2 18 
